11110000000000000000000000011111
11110100011110111111111111011111
11110100111111111000011111000000
11110100111110111000011111111110
11110111111000111111111111111110
11110111111011111110001100011110
11110111110011111110001100011110
11110111110011111100111111011110
11110111110011111100111111011110
11110111100011111000111111011110
00000001100011110000111111000000
01111111111111110111111111111110
01111101111111111111111110110010
01110111011111111111111110110010
01100000000111110111111110001110
01100000000111110000010000000000
01110101011111110111111101111111
01111111110111110111111101111111
01111111111111110111111001111111
11111111111111110111111101111111
11111111111111110000011001111111
01111111111111110000011101111111
01000000000011110000011101111111
00000000000000000000000001111111
