10000000000000000000000000000000
11111111110111010111111111111110
01010000010101010100000100001000
01011101110101110111110111011010
01000100010100000000010001000010
01010111011101110111110111011110
01010001000001010100000101010000
01011101111101011101110101010110
01010100000101000001010101010010
01010111110111011111010101011110
01000100010000010001010101000010
01110111011111010111010100011110
00010001010000010100010111111110
01110111011111110101110000000000
01000100000000010101000111111110
01110101111111000101110100100000
00010101000001011100010101101110
01010001011101010001010100001010
01010111010101110111010111111010
01010100010100000101010000000010
01110101110111110101010111101110
01000101000001000101010100101010
01111101111101111101111101111011
00000000000000000000000000000000
