00000000000000000000000000000000
01111101111101111111110111111110
01010001010101000000010100000000
01011111010101010111110111111110
01000000010101010100000000000110
01011101110111010111111101110110
00010101000000010000000101010110
01110111010111011111110111010110
01000000010101010100000000010110
01011111011101010111011111010110
01000101010001010001010101010110
11110101010101110101110101010111
01010101010100000100000101010110
01010101011111111101111101010110
00010101000000000101000001010110
01110101111101110101110111010110
01000100010101000100010100010110
01011111010111011101110100010010
01000001010000010001000111011110
01010101010111110101110001000010
01010101010111110101111101111010
01010101010100000100000100000010
01110111011111111111110111111110
00000000000000000000000000000000
