00000000000000000000000000000000
01111110101010101010101111111110
00111100011111111111101111111110
01111100111110101010101111011110
00111110011110000000001111011010
01111100111110101010101111011110
00111100011111111111101111011110
01111110111111111111100000011110
00111100111111111111111111111110
01111100111111111111111111111110
00111110100010001111100000000000
01111100111111111111110101010100
00111100100010001111111111111110
01111111111111111111111111111110
00111111111111111111111111111110
01111110111111111111111111111110
01111100111111111111110101010100
00011000000000000111100000000000
01111110101010101111110101010110
00111111111111111111111111111100
01111111111111111111111111111110
00111111111111111111111111111100
01010101010101010101010101010110
00000000000000000000000000000000
