11111111111111111111111111111111
01110101010101010101010101010101
11111010101010101010101010101010
01111101010101010101010101010101
10110110101010101010101010101010
01011011010101010101010101010101
10111010101010101010101010101010
01010111010101010101010101010101
10101100001010101010101010101010
01010110110101010101010101010101
10101011011110101010101010101010
01010101111101010101010101010101
10101010111010101010101010101010
01010101010101010101010101010101
10101010101010101010101010101010
01010101010101010101010101010101
10101010101010101010101010101010
01010101010101010101010101010101
10101010101010101010101010101010
01010101010101010101010101010101
10101010101010101010101010101010
01010101010101010101010101010101
10101010101010101010101010101010
11111111111111111111111111111111
