00000000000000001111111111111111
01001010101010101111111111111111
01111011111110101111111111111111
01111011110111101111111111111111
01001111111000101111111111111111
01111111111000101111111111111111
01111011111110100000000000000000
01111001111111111111111111000110
01111001111111111111111111100110
01111001111111111111111111110110
00110000000000000000110011110110
01111011111111111111111011110110
01101011111111111111110011111110
01111001111111111111110011111110
01111001111111111111111011010110
01111011111111111111111011110110
01111011111100000110000001100110
01111011111101111111101111100110
01111000000001111111101111110110
01111111111101111111100001110110
00111111111101111111100000000110
00011111111101111111111011111110
00111111111101111111111011111110
00000000000000000000000000000000
