11111111111111111111111111111111
01110101010101010101010101010101
11111010101010101010101010101010
01111101010101010101010101010101
10111110101010101010101010101010
01011111010101010101010101010101
10111111101010101010101010101010
01011111110101010101010101010101
10101111111010101010101010101010
01010111111101010101010101010101
10101011111110101010101010101010
01010101111101010101010101010101
10101010111010101010101010101010
01010101010101010101010101010101
10101010101010101010101010101010
01010101010101010101010101010101
10101010101010101010101010101010
01010101010101010101010101010101
10101010101010101010101010101010
01010101010101010101010101010101
10101010101010101010101010101010
01010101010101010101010101010101
10101010101010101010101010101010
11111111111111111111111111111111
